NO ./images/c.png
SO ./images/left.png
WE ./images/c.png
EA ./images/c.png

F 72, 72, 79
C 34, 36, 35

	111111111111111111111111111111
	1000000000110000000000000111
	10110000011100000000000000001
	10001000000000000000000001   
111111111011000001110000000000001
100000000011000001110111111111111
11110111111111011100000010001
11110111111111011101010010001
11000000110101011100000010001
10000000000000001100000010001
10000000000000001101010000001
110000011101010N111101111000111
11110111 1110101  101111010001
11111111 1111111  111111111111
11111111 1111111 111111111111

