NO ./images/c.png
SO ./images/left.png
F 255, 72,79
C 34, 36, 35
WE ./images/c.png
EA ./images/c.png


11111111111111111111111111111111111111111111111111111111111   1111111111111111111111111111111111111111111111111111111111111111111111111111111111
10000000000000000000000000000000000000000000000000000000001 1 10000000000000000000000000000000000000000000000000000000000000000000000000000000111111111
10000000000000000000000000000000000000000000000000000000001   100000000000000000000000000000000000000000000000000000000000000000000000000000111111111
1000001111111111111111111111111111111111111111111111111111111111000000000000000000000000000000000000000000000000000000000000000000000000000001000000011
10000011111111111111111111111111111111111111111111111111111  1 11111111111111111111111111111111111111111111111111111111111111111111111111000001111111101
1000001111111111111111111111111111111111111111111111111110111111111111111111111111111111111111111111111111111111111111111111111111111111000001111111111
100000000000000000000000000000000000N00000000000000000000011110000000000000000000000000000000000000000000000000000000000000000000000000000001
1000000000000000000000000000000000000000000000000000000000000000000000000000000000000000000000000000000000000000000000000000000000000000000001
1111111111111111111111111111111111111111111111111111111111111111111111111111111111111111111111111111111111111111111111111111111111111111111111
