NO ./path_to_the_north_texture
SO ./path_to_the_south_texture
WE ./path_to_the_west_texture
EA ./path_to_the_east_texture

F 220,100,0
C 225,30,0

111111111111111111111111111111111
100000000011000000000000111111111
101100000111000000000000111111111
100100000000000000000000111111111
111111110011000001110000000000001
100000000011000001110111111111111
111101111111110111000000100011111
111101111111110111010100100011111
110000001101010111000000100011111
1000000N0000000011000000100011111
100000000000000011010100000011111
110000011101010111110111100011111
11110111 1110101  101111010001111
11111111 1111111  111111111111111
11111111 1111111  111111111111111
111111111111111111111111111111111
