NO ./images/gtawall.png
SO ./images/gtawall.png
WE ./images/gtawall.png
EA ./images/gtawall.png

F 98,92,89
C 236, 211, 167

11111111111111111111111111111111111111111111111111111111111111111111111111111111111111111111111111111111
1000000000000Y0000000000L000000000000000000000L000000000000000000Y00000000000000000000L00000000000000001
10000000000000000000000000000000000000000000000000000000000000000000000000000000000000000000000000000001
10000000000000000000000000000000000000000000000000000000000000000000000000000000000000000000000000000001
10000000000000000000000000000000000000000000000000000000000000000000000000000000000000000000000000000001
100000000000000000Y000000000000000000000000000000000000001000000000L000000000000000000000000000000000001
10000011111111L1111111111111L1111111111111111L11111111111l1111111111111111111111111111111111111111000001
100000111111111111110101111111111111110T01111111111111100y0010111111111111111111111111101011111111000001
10000000000000000T000000000000000T00000000000000000000111D11100000000000000000000T0000000000000000000001
10000000000000000000000000000000000000000000000000000000000000000000000000000000000000000000000000000001
10000000000000000000000000000000000000000000000000000000000000000000000000000000000000000000000000000001
10000000000000000000000000000000000000000000000000000000000000000000000000000000000000000000000000000001
100000100000000010000T00001000000000000T0000000010000000010000000001000Y000T0000000000100000000001000001
11111111111111111111111111110000111111111111111111111111111111111111111111111111111111111111111111111111
         1111111110100000000000000000001
         111T010110000000000000000000001
         110T010001110001000000010111111
         1110111110001D10101110111011101111
         11000001000000010100010T0001010101
         1111010111011111010111111101010111
         110100T1010000000001000T010100011
         11110111010111111111010110001111
          11110101000101T000010100000011
           1111111101011111111111111111
            10111110111110111111111
             111111N1111111111111
                 1111111111111