NO ./images/BRICK_2B.png
SO ./images/BRICK_2B.png
WE ./images/BRICK_2B.png
EA ./images/BRICK_2B.png

F 60,44,36
C 92,68,44

        1111111111111111111111111
        1000000000110000000000001
        1011000001110000000100001
        1001000000000000000100011
111111111011000001110000000000001
100000000011000001110111111111111
11110111111111011100000010001
11110111111111011101010010001
11000000110101011100000010001
1000N0000Y00Y00001100000010001
1Y000000000000001101011111D1111
11000001110101011110000000000111
11110111 1110101  100000000001
11111111 1111111  110000000001
11111111 1111111  110000000001
111111111111111111111111111111