NO ./images/88.png
SO ./images/88.png
WE ./images/88.png
EA ./images/88.png

F 40,35,33
C 34, 36, 35

111111111111111111111111111111111111111111111111111111111111111111111111111111111111111111111111111111111111111111111111111111111111111111111111
100000000000000000000000000000000000000000000000000000000000000000000000000000000000000000000000000000000000000000000000000000000000000000000001
100000000000000000000000000000000000000000000000000000000000000000000000000000000000000000000000000000000000000000000000000000000000000000000001
1000000000000000000000000000000000000000000000000000000000000000000L0000000000000000000000000000000000000000000000000000000000000000000000000001
10000011111111L1111111111111L1111111111111111L111111111111111111111111100001111111111111111111111111111111111111111L1111111111111111111111000001
100000111111111111110101111111111111110101111111111111111110101111111100001111111111111010111111111111101011111111111111110101111111111111000001
100000000000000000000000000000000000000000000000000000000000000000000000000000000000000000000000000000000000000000000000000000000000000000000001
100000000000000000000000000000000000000000000000000000000000000000000000000000000000000000000000000000000000000000000000000000000000000000000001
100000100000000010000000001000000100000100000000100000000100000000010000000000000000001000000000010000000001000000000001000000000000000000000001
111111111111111111111111111111111111111111111111111111111111111111111111100000111111111111111111111111111111111111111111111111111111111111111111
            111111111111111111111111111111111111111111111111101000000000000000000000000011111111111111111111111111111111111111111111111111111111
            111111111111111111111111111111111111111111100101100000000000000000000000011111111111111111111111111111111111111111111111111
            1111111111111111111111111111111111111111110001l0yD0000000010000000100000000010100011111111111111111111111111111
            11111111111111111111111111111111111111111110111111011110101110111011101110101110111111111111111111111111111
            11111111111111111111111111111111111111111100000101010101010001000001010100000000011111111111111111111
            111111111111111111111111111111111111111111110101110111110101111111010101110111111111111111111111111111111
            111111111111111111111111111111111111111111010001010000000001000001010001010001000111111111111111111111111
            111111111111111111111111111111111111111111110111010111111111010111110101111111010101111111111111111111111
            111110001111111111111111111111111111111111110101010101000001010000010000010100000101111111111111111111111
            111111111111111111111111111111111111111111111111110111111111111111111111111111111111111111111111111111111
            111111111111111111111111111111111111111111110111110111110111111111111111111111111111111111111111111111111
            11111111111111111111111111111111111111111111111111N111111111111111111111111111111111111111111111111111111
            111111111111111111111111111111111111111111111111111111111111111111111111111111111111111111111111111111111