NO ./images/88.png
SO ./images/88.png
WE ./images/88.png
EA ./images/88.png

F 60,44,36
C 92,68,44

        1111111111111111111111111
        1000000001100000000000011
        1011000001110000000100001
        1001000000000000000100011
111111111011000001110000000000001
100000000011000001110111111111111
11110111111111011100000010001
1111D111111111011101010010001
11000000000001011100000010001
1000N0000Y00Y00001100000010001
10Y00000000000001101011111D1111
1111111111111111111111111111111