
NO ./images/88.png
SO ./images/88.png
WE ./images/88.png
EA ./images/88.png

F 40,35,33
C 34, 36, 35

111111111111111111111111111111111111111111111111111111111111111111111111111111111111111111111111111111111111111111111111111111111111111111111111
1000000000000000000000000000000000000000000000000000000T0000000000000000000000000000000000000000000000000000000000000000000000000000000000000001
100000000000000000000000000000000000000000000000000000000000000000000000000000000000000000000000000000000000000000000000000000000000000000000001
10000000000000000000000000000000000000000000000T000000T000000T0000000000000000000000000000000000000000000000000000000000000000000000000000000001
100000111111111111111111111111111111111111111111111111111111111111111110000111111111111111111111111111111111111111111111111111111111111111000001
100Y00111111111111111111111111111111111111111111111111111111111111111110000111111111111111111111111111111111111111111111111111111111111111000001
100000000000000000000000000000000000000000000000000000000000000000000000000000000000000000000000000000000000000000000000000000000000000000000001
10000000000000000000000000000000000000000000000000000000000000000000000000000Y000000000000000000000000000000000000000000000000000000000000000001
100000000000000000000000000000000000000000000000T0000000000000T000000000000000000000000000000000000000000000000000000000000000000000000000000001
1111111111111111111111111111111111111111111111111111111111111111111111111N0000111111111111111111111111111111111111111111111111111111111111111111
111111111111111111111111111111111111111111111111111111111111101000000000000000000000000011111111111111111111111111111111111111111111111111111111
111000111111111111111111111111111111111111111111111111111100101100000000000000000000000011111111111111111111111111111111111111111111111111111111
111111111111111111111111111111111111111111111111111111000100D000000001000000010000000001010001111111111111111111111111111111111111111111111111
11111111111111111111111111111111111111111111111111111110110010101110101110111011101110101110111111111111111111111111111
11111111111111111111111111111111111111111111111111111111000110010101010100010000010101000000000111111111111111111111111111
111111111111111111111111111111111111111111111111111111110101110111110101111111010101110111111111111111111111111111111111111111111111111111111111
111111111111111111111111111111111111111111111111111111110100000100000000010000010100010100010001111111111111111111111111111111111111111111111111
111111111111111111111111111111111111111111111111111111110111011111111111010111110101111111010101111111111111111111111111111111111111111111111111
111111111111111111111111111111111111111111111111111111110101010001000001010000010000010100000101111111111111111111111111111111111111111111111111
111111111111111111111111111111111111111111111111111111111111111111111111111111111111111111111111111111111111111111111111111111111111111111111111